He sings: Obtained: [ROOT [S [NP [PRP He]][VP [VBZ sings]]]]
I run: Obtained: [ROOT [S [NP [PRP I]][VP [VBP run]]]]
We eat: Obtained: [ROOT [S [NP [PRP We]][VP [VBP eat]]]]
You sleep: Obtained: [ROOT [S [NP [PRP You]][VP [VBP sleep]]]]
It works: Obtained: [ROOT [S [NP [PRP It]][VP [VBZ works]]]]
He talks: Obtained: [ROOT [S [NP [PRP He]][VP [VBZ talks]]]]
She reads: Obtained: [ROOT [S [NP [PRP She]][VP [VBZ reads]]]]
I love you: Obtained: [ROOT [S [NP [PRP I]][VP [VBP love][NP [PRP you]]]]]
She eats cake: Obtained: [ROOT [S [NP [PRP She]][VP [VBZ eats][NP [NN cake]]]]]
They run fast: Obtained: [ROOT [S [NP [PRP They]][VP [VBP run][ADVP [RB fast]]]]]
He drives car: Obtained: [ROOT [S [NP [PRP He]][VP [VBZ drives][NP [NN car]]]]]
Dogs chase cats: Obtained: [ROOT [S [NP [NNS Dogs]][VP [VBP chase][NP [NNS cats]]]]]
We play games: Obtained: [ROOT [S [NP [PRP We]][VP [VBP play][NP [NNS games]]]]]
I drink water: Obtained: [ROOT [S [NP [PRP I]][VP [VBP drink][NP [NN water]]]]]
Birds fly high: Obtained: [ROOT [S [NP [NNP Birds]][VP [VBP fly][ADJP [JJ high]]]]]
She reads book: Obtained: [ROOT [S [NP [PRP She]][VP [VBZ reads][NP [NN book]]]]]
He sings song: Obtained: [ROOT [S [NP [PRP He]][VP [VBZ sings][NP [NN song]]]]]
She sings beautifully: Obtained: [ROOT [S [NP [PRP She]][VP [VBZ sings][ADVP [RB beautifully]]]]]
He walks slowly: Obtained: [ROOT [S [NP [PRP He]][VP [VBZ walks][ADVP [RB slowly]]]]]
They run quickly: Obtained: [ROOT [S [NP [PRP They]][VP [VBP run][ADVP [RB quickly]]]]]
The sun shines brightly: Obtained: [ROOT [S [NP [DT The][NN sun]][VP [VBZ shines][ADVP [RB brightly]]]]]
The rain pours heavily: Obtained: [ROOT [S [NP [DT The][NN rain]][VP [VBZ pours][ADVP [RB heavily]]]]]
I love pizza too: Obtained: [ROOT [S [NP [PRP I]][VP [VBP love][NP [NN pizza]][ADVP [RB too]]]]]
The bird flies high: Obtained: [ROOT [S [NP [DT The][NN bird]][VP [VBZ flies][ADJP [JJ high]]]]]
The car drives fast: Obtained: [ROOT [S [NP [DT The][NN car]][VP [VBZ drives][ADVP [RB fast]]]]]
He is eating lunch: Obtained: [ROOT [S [NP [PRP He]][VP [VBZ is][VP [VBG eating][NP [NN lunch]]]]]]
She bought red shoes: Obtained: [ROOT [S [NP [PRP She]][VP [VBD bought][NP [JJ red][NNS shoes]]]]]
They run every morning: Obtained: [ROOT [S [NP [PRP They]][VP [VBP run][NP-TMP [DT every][NN morning]]]]]
The cat chased a mouse: Obtained: [ROOT [S [NP [DT The][NN cat]][VP [VBD chased][NP [DT a][NN mouse]]]]]
We saw a rainbow: Obtained: [ROOT [S [NP [PRP We]][VP [VBD saw][NP [DT a][NN rainbow]]]]]
The cat chased the mouse: Obtained: [ROOT [S [NP [DT The][NN cat]][VP [VBD chased][NP [DT the][NN mouse]]]]]
She sings in choir practice: Obtained: [ROOT [S [NP [PRP She]][VP [VBZ sings][PP [IN in][NP [NN choir][NN practice]]]]]]
We went to the beach: Obtained: [ROOT [S [NP [PRP We]][VP [VBD went][PP [TO to][NP [DT the][NN beach]]]]]]
He gave her the gift: Obtained: [ROOT [S [NP [PRP He]][VP [VBD gave][NP [PRP$ her]][NP [DT the][NN gift]]]]]
They found the lost dog: Obtained: [ROOT [S [NP [PRP They]][VP [VBD found][NP [DT the][VBN lost][NN dog]]]]]
He ate a big pizza: Obtained: [ROOT [S [NP [PRP He]][VP [VBD ate][NP [DT a][JJ big][NN pizza]]]]]
The black cat climbs trees: Obtained: [ROOT [S [NP [DT The][JJ black][NN cat]][VP [VBZ climbs][NP [NNS trees]]]]]
They drink cold lemonade outside: Obtained: [ROOT [S [NP [PRP They]][VP [VBP drink][NP [JJ cold][NN lemonade]][ADVP [IN outside]]]]]
I play guitar every day: Obtained: [ROOT [S [NP [PRP I]][VP [VBP play][NP [NP [NN guitar]][NP [DT every][NN day]]]]]]
The book is on the table: Obtained: [ROOT [S [NP [DT The][NN book]][VP [VBZ is][PP [IN on][NP [DT the][NN table]]]]]]
The sun sets in the west: Obtained: [ROOT [S [NP [DT The][NN sun]][VP [VBZ sets][PP [IN in][NP [DT the][NN west]]]]]]
Cats love chasing small moving things: Obtained: [ROOT [S [NP [NNS Cats]][VP [VBP love][S [VP [VBG chasing][NP [JJ small][VBG moving][NNS things]]]]]]]
Raindrops fall gently on green leaves: Obtained: [ROOT [S [NP [NNS Raindrops]][VP [VBP fall][ADVP [RB gently]][PP [IN on][NP [JJ green][NNS leaves]]]]]]
She gave her friend the book: Obtained: [ROOT [S [NP [PRP She]][VP [VBD gave][NP [PRP$ her][NN friend]][NP [DT the][NN book]]]]]
The cat and the dog played: Obtained: [ROOT [S [NP [NP [DT The][NN cat]][CC and][NP [DT the][NN dog]]][VP [VBD played]]]]
He always drinks coffee after breakfast: Obtained: [ROOT [S [NP [PRP He]][VP [ADVP [RB always]][VBZ drinks][NP [NN coffee]][PP [IN after][NP [NN breakfast]]]]]]
My parents are traveling to Europe: Obtained: [ROOT [S [NP [PRP$ My][NNS parents]][VP [VBP are][VP [VBG traveling][PP [TO to][NP [NNP Europe]]]]]]]
The tall man in the hat is my uncle: Obtained: [ROOT [S [NP [NP [DT The][JJ tall][NN man]][PP [IN in][NP [DT the][NN hat]]]][VP [VBZ is][NP [PRP$ my][NN uncle]]]]]
She played the piano beautifully in the concert: Obtained: [ROOT [S [NP [PRP She]][VP [VBD played][NP [DT the][NN piano]][ADVP [RB beautifully]][PP [IN in][NP [DT the][NN concert]]]]]]
I will study for the exam tomorrow: Obtained: [ROOT [S [NP [PRP I]][VP [MD will][VP [VB study][PP [IN for][NP [DT the][NN exam]]][NP-TMP [NN tomorrow]]]]]]
They bought a house in the countryside: Obtained: [ROOT [S [NP [PRP They]][VP [VBD bought][NP [DT a][NN house]][PP [IN in][NP [DT the][NN countryside]]]]]]
The children are laughing and playing in the park: Obtained: [ROOT [S [NP [DT The][NNS children]][VP [VBP are][VP [VBG laughing][CC and][VBG playing][PP [IN in][NP [DT the][NN park]]]]]]]
She couldn't remember the name of the song: Obtained: [ROOT [S [NP [PRP She]][VP [MD could][RB n't][VP [VB remember][NP [NP [DT the][NN name]][PP [IN of][NP [DT the][NN song]]]]]]]]
Smoking is good for your health:[ROOT [S [NP [NN Smoking]] [VP [VBZ is] [ADJP [JJ good] [PP [IN for] [NP [PRP your] [NN health]]]]]]]: Obtained: [ROOT [S [NP [NN Smoking]][VP [VBZ is][ADJP [JJ good][PP [IN for][NP [NP [PRP$ your][NN health]][: :][-LRB- -LSB-][SBARQ [FRAG [INTJ [NN ROOT][-LRB- -LSB-][NN S]][-LRB- -LSB-][NP [NP [NN NP]][PP [-LRB- -LSB-][NP [NNP NN][NNP Smoking]]]][-RRB- -RSB-]][-RRB- -RSB-][SBARQ [WHNP [-LRB- -LSB-][NN VP][-LRB- -LSB-][NN VBZ]][SQ [VBZ is][NP [NP [-RRB- -RSB-][NP [NP [-LRB- -LSB-][NN ADJP][-LRB- -LSB-]][NN JJ][ADJP [JJ good][-RRB- -RSB-][-LRB- -LSB-]][NN PP]][-LRB- -LSB-][ADJP [IN IN][PP [IN for][S [VP [-RRB- -RSB-][NP [NP [-LRB- -LSB-][NN NP]][PP [-LRB- -LSB-][NP [NN PRP]]]]]]]][NP [PRP$ your][-RRB- -RSB-][-LRB- -LSB-]][NNP NN][NN health]][PP [-RRB- -RSB-][NP [-RRB- -RSB-][-RRB- -RSB-][-RRB- -RSB-]]]]][-RRB- -RSB-]][-RRB- -RSB-]]]]]][-RRB- -RSB-]]]
This is a no smoking zone: Obtained: [ROOT [S [NP [DT This]][VP [VBZ is][NP [DT a][DT no][NN smoking][NN zone]]]]]
She is smoking: Obtained: [ROOT [S [NP [PRP She]][VP [VBZ is][NP [NN smoking]]]]]
They are smoking in a non smoking zone: Obtained: [ROOT [S [NP [PRP They]][VP [VBP are][VP [VBG smoking][PP [IN in][NP [DT a][JJ non][NN smoking][NN zone]]]]]]]
The smoking fire was due to wet firewood: Obtained: [ROOT [S [NP [DT The][NN smoking][NN fire]][VP [VBD was][ADJP [JJ due][PP [TO to][NP [JJ wet][NN firewood]]]]]]]
The blue and green striped shirt that I bought yesterday at the department store was on sale: Obtained: [ROOT [S [NP [NP [DT The][ADJP [JJ blue][CC and][JJ green]][JJ striped][NN shirt]][SBAR [IN that][S [NP [PRP I]][VP [VBD bought][NP-TMP [NN yesterday]][PP [IN at][NP [DT the][NN department][NN store]]]]]]][VP [VBD was][PP [IN on][NP [NN sale]]]]]]
The large wooden table with the intricate carvings that my grandfather made by hand was the centerpiece of the dining room: Obtained: [ROOT [S [NP [NP [DT The][JJ large][JJ wooden][NN table]][PP [IN with][NP [NP [DT the][JJ intricate][NNS carvings]][SBAR [WHNP [WDT that]][S [NP [PRP$ my][NN grandfather]][VP [VBN made][PP [IN by][NP [NN hand]]]]]]]]][VP [VBD was][NP [NP [DT the][NN centerpiece]][PP [IN of][NP [DT the][NN dining][NN room]]]]]]]
The old red brick building at the end of the street has been abandoned for decades: Obtained: [ROOT [S [NP [NP [DT The][JJ old][JJ red][NN brick][NN building]][PP [IN at][NP [NP [DT the][NN end]][PP [IN of][NP [DT the][NN street]]]]]][VP [VBZ has][VP [VBN been][VP [VBN abandoned][PP [IN for][NP [NNS decades]]]]]]]]
A large wooden ship with three masts and billowing white sails sailed across the calm blue ocean: Obtained: [ROOT [S [NP [NP [DT A][JJ large][JJ wooden][NN ship]][PP [IN with][NP [NP [CD three][NNS masts]][CC and][S [VP [VBG billowing][NP [JJ white][NNS sails]]]]]]][VP [VBD sailed][PP [IN across][NP [DT the][ADJP [JJ calm][JJ blue]][NN ocean]]]]]]
The tall blonde woman in the red dress and high heels was the center of the attention at the party: Obtained: [ROOT [S [NP [NP [DT The][JJ tall][JJ blonde][NN woman]][PP [IN in][NP [NP [DT the][JJ red][NN dress]][CC and][NP [JJ high][NNS heels]]]]][VP [VBD was][NP [NP [DT the][NN center]][PP [IN of][NP [NP [DT the][NN attention]][PP [IN at][NP [DT the][NN party]]]]]]]]]
The small white cottage with a thatched roof nestled among the rolling hills was a perfect hideaway: Obtained: [ROOT [SINV [S [NP [NP [DT The][JJ small][JJ white][NN cottage]][PP [IN with][NP [DT a][JJ thatched][NN roof]]]][VP [VBD nestled][PP [IN among][NP [DT the][VBG rolling][NNS hills]]]]][VP [VBD was]][NP [DT a][JJ perfect][NN hideaway]]]]
The fluffy white clouds floated lazily across the bright blue sky: Obtained: [ROOT [S [NP [DT The][JJ fluffy][JJ white][NNS clouds]][VP [VBD floated][ADVP [RB lazily]][PP [IN across][NP [DT the][JJ bright][JJ blue][NN sky]]]]]]
The sky was a canvas of orange and pink strokes: Obtained: [ROOT [S [NP [DT The][NN sky]][VP [VBD was][NP [NP [DT a][NN canvas]][PP [IN of][NP [NN orange][CC and][JJ pink][NNS strokes]]]]]]]
The silence was so thick that you could hear a pin drop: Obtained: [ROOT [S [NP [DT The][NN silence]][VP [VBD was][ADJP [RB so][JJ thick]][SBAR [IN that][S [NP [PRP you]][VP [MD could][VP [VB hear][NP [DT a][NN pin][NN drop]]]]]]]]]
The flowers danced to the rhythm of the wind: Obtained: [ROOT [S [NP [DT The][NNS flowers]][VP [VBD danced][PP [TO to][NP [NP [DT the][NN rhythm]][PP [IN of][NP [DT the][NN wind]]]]]]]]
The wind whispered secrets to the trees: Obtained: [ROOT [S [NP [DT The][NN wind]][VP [VBD whispered][NP [NNS secrets]][PP [TO to][NP [DT the][NNS trees]]]]]]
The river flowed like a silver ribbon: Obtained: [ROOT [S [NP [DT The][NN river]][VP [VBD flowed][PP [IN like][NP [DT a][NN silver][NN ribbon]]]]]]
The storm was a raging bull: Obtained: [ROOT [S [NP [DT The][NN storm]][VP [VBD was][NP [DT a][VBG raging][NN bull]]]]]
